+------------+
| >>         |
|            |
|   s        |
|	     |
| >>>>>  >>> |
|            |
|   h        |
+------------+